57 32
41 41 41 41 41 41 41 41 41 41  2  2  2  2  2  2  2  2  2  2  2  2  2  2  2  2  2  2  2  2  2  2  2  2  2  2  2  2  2  2  2  2  2  2  2  2  2  2  2  2  2  2  2  2  2  2  2
44  3  3  3  3  3  3  3  3 41 41 41 41  2  2  2 82 83  2  2  2  2  2  2  2  2  2  2  2  2  2  2  2  2  2  2  2  2  2  2  2  2  2  2  2  2  2  2  2  2  2  2  2  2  2  2  2
44  3  3  3  3  3  3  3  3  3  3  3 41 41 41 41 84 85  2  2  2  2  2  2  2  2  2  2  2  2  2  2  2  2  2  2  2  2  2  2  2  2  2  2  2  2  2  2  2  2  2  2  2  2  2  2  2
44  3  3  3  3  3  3  3  3  3  3  3  3  3  3 41 41 41 41 41 41 41 41 41 41 41 41 41 41 41 41 41 41 41 41 41 41 41 41 41 41 41 41 41 41 41 41 41 41 41 41 41 41 41 41 41 42
44  3  3  3  3  3  3  3  3  3  3  3  3  3  3  2  2  2  2  2  2  2  2  2  2  2  2  2  2  2  2  2 67  2  2  2  2  2  2  2  2  2  2 63  2 63  2 63  2 63  2 63  3  3  3  3 42
44  3  3  2 35 13 12 13 12 13 12 13 12 13 37  2 58 59 60  2 58 59 60  2 58 59 60  2 58 59 60  2 67 58 59 60  2 58 59 60  2  2 35 13 12 13 12 13 12 13 12 38  3  3  3  3 42
44  3  3  2 11  7  7  7  7  7  7  7  7  7  7  5  7  7  5  7  7  5  7  7  5  7  7  5  7  7  5  7  4  7  7  7  7  7  7  7  7  7  7  7  7  7  7  7  7  7  7 14  3  3  3  3 42
44  3  3  2 10  7  7  7  7  7  7  7  7  7  7  7  7  7  7  7  7  7  7  7  7  7  7  7  7  7  7  7  4  7  7  7  7  7  7  7  7  7  7  7  7  7  7  7  7  7  7 15  3  3  3  3 42
44  3  3  2 11  7  7  7  7  7  7  7  7  7  6  7  7  6  7  7  6  7  7  6  7  7  6  7  7  6  7  7  4  7  7  7  7  7  7  7  7  7  7  7  7  7  7  7  7  7  7 14  3  3  3  3 42
44  3  3  2 10  7  7  7 18  9  8 40 61 62 24 25 52 47 47 56 29 24 24 24 24 24 24 24 24 24 24 24 68 24 24 24 24 24 24 24 24 24 24 24 34  8  9 20  7  7  7 15  3  3  3 42 42
44  3  3  2 11  7  7  7 15 69 69 69 43 43 43 24 26 53 46 46 57 30 42 43 43 43 43 43 43 43 43 43 43 43 43 43 43 43 43 43 43 43 43 43 43 43 43 11  7  7  7 14  3  3  3 42  2
44  3  3  2 10  7  7  7 14 69 69 69 42  2 44 24 24 25 52 45 45 45 45 45 45 45 45 45 45 45 45 45 66 45 45 45 45 45 45 45 45 45 45 45 56 24 42 10  7  7  7 15  3  3  3 42  2
44  3  3  2 34  7  7  7 40 69 69  2 42  2 44 24 24 24 26 53 45 45 45 45 45 45 45 45 45 45 45 45 66 45 45 45 45 45 45 45 45 45 45 45 45 57 42 34  7  7  7 14  3  3 42 42  2
44  3  3  2 63  7  7  7  2 69  2  2 42  2 44 58 59 60 24 25 52 45 45 45 71 72 73 74 75 76 77 45 66 45 49 45 45 49 45 45 45 45 45 45 45 45 56 24  7  7  7 15  3  3 42  2  2
44  3  3  2  2  7  7  7 63  2  2  2 42  2 44 58 59 60 24 24 26 53 45 45 80 81 80 81 45 80 81 45 66 45 45 80 81 45 45 45 45 45 78 79 45 45 45 57  7  7  7 39  3  3 42  2  2
44  3  3  2 63  7  7  7  2  2  2  2 42  2 43 43 43 43 43 43 43 43 43 43 41 41 41 41 41 41 41 41 41 41 41 41 41 41 41 41 41 41 24 25 53 45 45 48  7  7  7  2  2 42 42  2  2
44  3  3  2  2  7  7  7 63  2  2  2 42  2  2  2  2  2  2  2  2  2  2 44  3  3 35 13 12 13 12 13 12 13 12 13 12 13 37  3  3 42 24 24 25 52 45 48  7  7  7  2  2 42 82 83  2
44  3  3  2 63  7  7  7  2  2  2  2 42  2  2  2  2  2  2  2  2  2  2 44  3  3 10  7  7  7  7  7  7  7  7  7  7  7  7  7  7 42 43 43 43 25 53 48  7  7  7 38  2 42 84 85  2
44  3  3  3 35  7  7  7 63  2  2  2 42  2  2  2  2  2  2  2  2  2  2 44  3  3 11  7  7  7  7  7  7  7  7  7  7  7  7  7  7 41 41 41 41 43 25 52  7  7  7 14  2 42  2  2  2
44  3  3  3 11  7  7  7  2  2  2  2 42  2  2  2  2  2  2  2  2 82 83 44  3  3 10  7  7  7  7  7  7  7  7  7  7  7  7  7  7 58 59 60  2 44  2 26  7  7  7 15  2 42  2  2  2
44  3  3  3 10  7  7  7 63 69 69  2 42  2  2  2  2  2  2  2  2 84 85 44  3  3 11  7  7  7 18  9 39 61 62 34  8 21  7  7  7 37  2 61 62 44 63 35  7  7  7 14  2 42  2  2  2
44  3  3  3 11  7  7  7 37 69 69 69 41 41 41 41 41 41 41 41 41 41 41 44 70 70 10  7  7  7 15 70 70 70 70 70 70 34  7  7  7 15 69 69 69 69 69 11  7  7  7 15  2 42  2  2  2
44  3  3  3 10  7  7  7 14 69 69 69 69  2  2  2  2  2  2  2  2  2  2 69 69 69 11  7  7  7 39 70 70 70 70 70 70 67  7  7  7 16 13 37  2 35 13 22  7  7  7 14  2 42  2  2  2
44  3  3  3 11  7  7  7 15 69 69 69 69 69  2  2  2  2  2  2  2  2 69 69 69 69 10  7  7  7  2  3 42 44 68 68 68  2  7  7  7  7  7  7  7  7  7  7  7  7  7 15  2 42  2  2  2
44  3  3  3 11  7  7  7 16 13 12 37  2 61 62 61 62 61 62 61 62 61 62  2 35 13 22  7  7  7  2  3 42 44  3  3  3  2  7  7  7  7  7  7  7  7  7  7  7  7  7 15  2 42  2  2  2
44  3  3  3 10  7  7  7  7  7  7  7  7  7  7  7  7  7  7  7  7  7  7  7  7  7  7  7  7  7  2  3 42 44  3  3  3  2  7  7  7  7  7  7  7  7  7  7  7  7  7 14  2 42  2  2  2
44  3  3  3 11  7  7  7  7  7  7  7  7  7  7  7  7  7  7  7  7  7  7  7  7  7  7  7  7  7  2  3 42 44  3  3  3 34  8  9  8  9  8  9  8  9  8  9  8  9  8 40  2 42  2  2  2
44  3  3  3 10  7  7  7  7  7  7  7  7  7  7  7  7  7  7  7  7  7  7  7  7  7  7  7  7  7  2  3 42 44  3  3  3  3  3  3  3  3  3  3  3  3  3  3  3  3  3  3  3 42 82 83  2
44  3  3  3 34  8  9  8  9  8  9  8 40  2 61 62 61 62  2 34  8  9  8  9  8  9 39  3  3  3  3  3 42 44 43 43 43 43 43 43 43  3  3  3  3  3  3  3  3  3  3  3  3 42 84 85  2
44  3  3  3  2  2  2  2  2  2  2  2  2  2  2  2  2  2  2  3  3  3  3  3  3  3  3  3  3  3  3  3 42  2  2  2  2  2 82 83 43 43 43 43  3  3  3  3  3  3  3  3  3 42  2  2  2
44 43 43 43 43 43 43 43 43 43 43 43 43 43 43 43 43 43 43 43 43 43 43 43 43  3  3  3  3  3  3  3 42  2  2  2  2  2 84 85  2  2  2 43 43 43 43  3  3  3  3  3  3 42  2  2  2
 2  2  2  2  2  2  2  2  2  2  2  2  2  2  2  2  2  2  2  2  2  2  2  2 43 43 43 43 43 43 43 43 43  2  2  2  2  2  2  2  2  2  2  2  2  2 43 43 43 43 43 43 43 43  2  2  2