70 40
7000 7000
41 41 41 41 41 41 42 82 83  2  2  2  2  2  2  2  2  2  2  2  2  2  2  2  2  2  2  2  2  2  2  2  2  2  2  2  2  2  2  2  2  2  2  2  2  2  2  2  2  2  2  2  2  2  2  2  2  2  2  2  2  2  2  2  2  2  2  2  2  2
44  3  3  3  3  3 42 84 85  2  2  2  2  2  2  2  2  2  2  2  2  2  2  2  2  2  2  2  2  2  2  2  2  2  2  2  2  2  2  2  2  2  2  2  2  2  2  2  2  2  2  2  2  2  2  2  2  2  2  2  2  2  2  2  2  2  2  2  2  2
44 24 64 65 24 24 41 41 41 41 41 41 41 41 41 41 41 41 41 41 41 41 41 41 41 41 41 41 41 41 41 41 41 41 41 41 41 41 41 41 41 41 41 41 41 41 41 41 41 41 41 41 41 41 41 41 41 41 41 41 41 41 41 41 41 41 41 41 41 42
44 12 13 12 13 12 39  2  2  2  2  2  2  2  2  2  2  2  2  2  2  2  2  2  2  2  2  2  2  2  2  2  2  2  2  2  2  2  2  2  2  2  2  2  2  2  2  2  2  2  2  2  2  2  2  2 36 12 13 12 13 12 13 12 13 37 24 24  3 42
44  7  7  7  7  7  7  7  7  7  7  7  7  7  7  5  7  7  5  7  7  5  7  7  5  7  7  5  7  7  5  7  7  5  7  7  5  7  4  7  7  7  7  7  7  7  7  7  7  7  7  7  7  7  7  7  7  7  7  7  7  7  7  7  7 14 24 24  3 42
44  7  7  7  7  7  7  7  7  7  7  7  7  7  7  7  7  7  7  7  7  7  7  7  7  7  7  7  7  7  7  7  7  7  7  7  7  7  4  7  7  7  7  7  7  7  7  7  7  7  7  7  7  7  7  7  7  7  7  7  7  7  7  7  7 15 24 24  3 42
44  7  7  7  7  7  7  7  7  7  7  7  7  7  6  7  7  6  7  7  6  7  7  6  7  7  6  7  7  6  7  7  6  7  7  6  7  7  4  7  7  7  7  7  7  7  7  7  7  7  7  7  7  7  7  7  7  7  7  7  7  7  7  7  7 14 24 24  3 42
44  7  7  7 19  8 40 24 24 24 25 52 47 47 47 56 29 64 65 24 64 65 24 64 65 24 64 65 24 64 65 24 64 65 24 64 65 24 64 65 24 64 65 24 64 65 24 64 65 24 64 65 24 64 65 24 24 33  9  8  9 20  7  7  7 15 24 24  3 42
44  7  7  7 14 42 43 43 43 43 43 26 53 46 46 46 57 30  2  2  2  2  2  2  2  2  2  2  2  2  2  2  2  2  2  2  2  2  2  2  2  2  2  2  2  2  2  2  2  2  2  2  2  2  2  2  2 70 70 70 70 11  7  7  7 14 24 24  3 42
44  7  7  7 40 42  2  2  2 43 43 43 25 52 45 45 45 56 29 42 43 43 43 43 43 43 43 43 43 43 43 43 43 43 43 43 43 43 43 43 43 43 43 43 43 43 43 43 43 43 43 43 43 43 43 43 43 70 70 70 27 22  7  7  7 15 24 24  3 42
44  7  7  7 42 42  2  2  2  2 43 43 43 26 53 45 45 45 57 30 42 41 41 41 41 41 41 41 41 41 41 41 41 41 41 41 41 41 41 41 41 41 41 41 41 41 41 41 41 41 41 41 42  2 82 83 44 70 70 28 23  7  7  7 18 14 24 24  3 42
44  7  7  7 42 82 83  2  2  2  2 43 43 43 25 52 45 45 45 45 45 45 45 45 45 45 45 45 45 45 45 45 45 45 45 45 45 45 45 66 45 45 45 45 45 45 45 45 45 45 45 45 42  2 84 85 44 70 27 22  7  7  7 19 31 24 24 24  3 42
44  7  7  7 42 84 85  2  2  2  2  2 43 43 43 26 53 45 45 45 45 45 45 45 45 45 45 45 45 45 45 45 45 45 45 45 45 45 45 66 45 45 45 45 45 45 45 45 45 45 45 45 42 44 44 44 24 28 23  7  7  7 18 32 24 43 43 43 43 43
44  7  7  7 41 41 41  2  2  2  2  2  2 43 43 43 25 52 45 45 45 45 45 45 45 45 45 45 45 45 45 45 45 45 45 45 45 45 45 66 45 45 45 45 45 45 45 45 45 45 45 45 42 44 44 24 27 22  7  7  7 19 31 24 42 42 82 83  2 42
44  7  7  7 30 41 41 41  2  2  2  2  2  2 43 43 43 26 53 45 45 71 72 73 74 75 76 77 45 45 45 45 49 45 45 45 49 45 45 66 45 45 45 49 45 45 45 45 45 45 45 45 42 44 24 28 23  7  7  7 18 32 24 42 42 42 84 85  2 42
44  7  7  7 16 29 41 41 41  2  2  2  2  2  2 43 43 43 25 52 45 80 81 45 80 81 45 80 81 45 45 80 81 45 45 80 81 45 45 66 45 45 80 81 45 45 78 79 45 45 45 45 42 24 27 22  7  7  7 19 31 24 42 42 42  2  2  2  2 42
44 20  7  7  7 17 30 41 41 41  2  2  2  2  2  2 43 43 43 43 43 43 43 43 43 43 43 43 43 43 43 43 43 43 43 43 43 43 43 43 43 43 43 43 43 43 43 43 43 45 45 45 24 28 23  7  7  7 18 32 24 42 42 42  2  2  2  2  2 42
44 25 21  7  7  7 16 29 41 41 41  2  2  2  2  2  2  2  2  2  2  2  2  2  2  2  2  2 41 41 41 41 41 41 41 41 41  2  2  2  2  2  2  2  2  2  2  2 44 45 45 45 27 22  7  7  7 19 31 24 42 42 42  2  2  2  2  2  2 42
44 24 26 20  7  7  7 17 30 41 41 41  2 82 83  2  2  2  2  2  2  2  2  2  2  2 82 83 44 3  3  3  3  3  3  3  42  2  2  2  2  2  2  2  2  2  2 44 44 48 48 48 23  7  7  7 18 32 24 42 42 42  2  2  2  2  2  2  2 42
44 44 24 25 21  7  7  7 16 29 41 41 41 84 85  2  2  2  2  2  2  2  2  2  2  2 84 85 44 24 24 24 24 24 24 24 42  2  2  2  2  2  2  2  2  2 44 44 44  7  7  7 7  7  7 19 31 24 42 42 42  2  2  2  2  2  2  2  2 42
 2 44 44 24 26 20  7  7  7 17 30 41 41 41 41 41 41 41 41 41 41 41 41 41 41 41 41 41 41 12 13 12 13 12 13 37 42 82 83  2  2  2  2  2  2 44 44 44 24  7  7  7  7  7 18 32 24 42 42 42  2  2  2  2  2  2  2  2  2 42
 2 44 44 44 24 25 21  7  7  7  7  7  7  7  7  7  7  7  7  7  7  7  7  7  7  7  7  7  7  7  7  7  7  7  7 15 42 84 85  2  2  2  2  2 44 44 44 24 27  7  7  7  7 19 31 24 42 42 42  2  2  2  2  2  2  2  2  2  2 42
82 83 44 44 44 24 26 20  7  7  7  7  7  7  7  7  7  7  7  7  7  7  7  7  7  7  7  7  7  7  7  7  7  7  7 14 42  2  2  2  2  2  2 44 44 44 24 28 23  7  7  7 18 32 24 42 42 42  2  2  2  2  2  2  2  2  2  2  2 42
84 85  2 44 44 24 24 25 21  7  7  7  7  7  7  7  7  7  7  7  7  7  7  7  7  7  7  7  7  7  7  7  7  7  7 15 42  2  2  2  2  2 44 44 44 24 27 22  7  7  7 19 31 24 42 42 42  2  2  2  2  2  2  2  2  2  2  2  2 42
 2  2  2  2 44 24 24 24 26 61 62 63 61 62 24 61 62 63 61 62 63 61 62 63 61 62 63 24 24 33  9 20  7  7  7 14 42  2  2  2  2 44 44 44 24 28 23  7  7  7 18 32 70 70 42  2  2  2  2  2  2  2  2  2  2  2  2  2  2 42
 2  2  2  2 44 43 43 43 43 43 43 43 43 43 43 43 43 43 43 43 43 43 43 43 43 43 43 43 43 43 44 11  7  7  7 15 42  2  2  2 44 44 44 24 27 22  7  7  7 19 31 70 70 70 42 82 83  2  2  2  2  2  2  2  2  2  2  2  2 42
 2  2  2  2  2  2  2 82 83  2  2  2  2  2  2  2  2  2  2  2  2  2  2  2  2  2  2  2 82 83 44 33  7  7  7 14 42  2  2 44 44 44 24 28 23  7  7  7 18 32 70 70 70 70 42 84 85  2  2  2  2  2  2  2  2  2  2  2  2 42
 2  2  2  2  2  2  2 84 85  2  2  2  2  2  2  2  2  2  2  2  2  2  2  2  2  2  2  2 84 85 44 24  7  7  7 15 42  2  2 44 44 24 27 22  7  7  7  7 16 13 12 13 12 38 41 41 41 41 41 41 41 41 41 41 41 41 41 41 41 42
 2  2  2  2  2  2  2  2  2  2  2  2  2  2  2  2  2  2  2  2  2  2  2  2  2  2  2  2  2 44 44 24  7  7  7 14 42  2  2 44  3 24 11  7  7  7  7  7  7  7  7  7  7  7  7  7  7  7  7  7  7  7  7  7  7  7  7  7 14 42
 2  2  2  2  2  2  2  2  2  2  2  2  2  2  2  2  2  2  2  2  2  2  2  2  2  2 82 83 44 44 44 28  7  7  7 15 42  2  2 44  3 24 10  7  7  7  7  7  7  7  7  7  7  7  7  7  7  7  7  7  7  7  7  7  7  7  7  7 15 42
 2  2  2  2  2  2  2  2  2  2  2  2  2  2  2  2  2  2  2  2  2  2  2  2  2  2 84 85 44 44 27 22  7  7  7 14 42  2  2 44  3 24 11  7  7  7  7  7  7  7  7  7  7  7  7  7  7  7  7  7  7  7  7  7  7  7  7  7 14 42
 2  2  2  2  2  2  2  2  2  2  2  2  2  2  2  2  2  2  2  2  2  2 44 41 41 41 41 41 41 28 23  7  7  7 18 32 42  2  2 44  3 24  9  8  9  8  9  8  9  8  9  8  9  8 43 43 43 43 43 43 43 43 33  9 20  7  7  7 15 42
 2  2  2  2  2  2  2  2  2  2  2  2  2  2  2  2  2  2  2  2  2  2 44  3 24 24 64 65 27 22  7  7  7 19 31 70 42 82 83 44  3 24 24 24 24 24 24 24 24 64 65 24 64 65 42  2  2  2  2  2  2 43 43 43 11  7  7  7 14 42
 2  2  2  2  2  2  2  2  2  2  2  2  2  2  2  2  2  2  2  2  2  2 44  3 24 61 62 28 23  7  7  7 18 32 70 70 42 84 85 44  3  3  3  3  3  3  3  3  3  3  3  3  3  3 42  2  2  2  2  2  2 82 83 44 10  7  7  7 15 42
 2  2  2  2  2  2  2  2  2  2  2  2  2  2  2  2  2  2  2  2  2  2 44  3 64 65 27 22  7  7  7 19 31 70 70 70 43 43 43 43 43 43 43 43 43 43 43 43 43 43 41 41 41 41 41 41 41 41 41 41  2 84 85 44 11  7  7  7 14 42
 2  2  2  2  2  2  2  2  2  2  2  2  2  2  2  2  2  2  2  2  2  2 44  3 24 28 23  7  7  7  7 16 12 13 12 38 24 24 61 62 63 61 62 63 61 62 63 61 62 63 61 62 63 61 62 63 61 62 63 41 41 41 41 44 10  7  7  7 15 42
 2  2  2  2  2  2  2  2  2  2  2  2  2  2  2  2  2  2  2  2  2  2 44  3 24 10  7  7  7  7  7  7  7  7  7  7  7  7  7  7  7  7  7  7  7  7  7  7  7  7  7  7  7  7  7  7  7  7  7  7  7  7  7  7  7  7  7  7 14 42
 2  2  2  2  2  2  2  2  2  2  2  2  2  2  2  2  2  2  2  2  2  2 44  3 24 11  7  7  7  7  7  7  7  7  7  7  7  7  7  7  7  7  7  7  7  7  7  7  7  7  7  7  7  7  7  7  7  7  7  7  7  7  7  7  7  7  7  7 15 42
 2  2  2  2  2  2  2  2  2  2  2  2  2  2  2  2  2  2  2  2  2  2 44  3 24 10  7  7  7  7  7  7  7  7  7  7  7  7  7  7  7  7  7  7  7  7  7  7  7  7  7  7  7  7  7  7  7  7  7  7  7  7  7  7  7  7  7  7 14 42
 2  2  2  2  2  2  2  2  2  2  2  2  2  2  2  2  2  2  2  2  2  2 43 43 43 43 43 43 43 43 43 43 43 43 43 43 43 43 43 43 43 43 43 43 43 43 43 43 43 43 43 43 43 43 43 43 43 43 43 43 43 43 43 43 43 43 43 43 43 43